{
	"title": "menu",
	"scale": 0.4,
	"grid": [
	"                                                                           ",
	"                                                                           ",
	"                                                                           ",
	"                                                                           ",
	"                                                                           ",
	"                                                                           ",
	"                                                                           ",
	"                                                                           ",
	"                                                                           ",
	"  *******                           **            ******              **   ",
	"  **    **                          **  **   **   *    **             **   ",
	"  **     **  ******   *******       **   ** **    *    **   ******  ****** ",
	"  **     **       **   **   **  ******    ***     ******   **    **   **   ",
	"  **     **  *******   **   ** **   **    **      *     ** **    **   **   ",
	"  **    **  **    **   **   ** **   **   **       *     ** **    **   **   ",
	"  *******    ******** ***   **  ******  **        *******   ******     **  ",
	"                                                                           ",
	"                                                                           ",
	"                                                                           ",
	"                                                                           ",
	"                                                                           ",
	"                                                                           ",
	"                                                                           ",
	"                                                                           ",
	"                                                                           "
	],
	"tiles": {
		" ": 731,
		"*": 542
	}
}
