{
	"title": "menu",
	"scale": 0.3,
	"grid": [
		"#*############*##*############*##*############*##*############*#",
		"**############****############****############****############**",
		"##*##########*####*##########*####*##########*####*##########*##",
		"###*#*####*#*######*#*####*#*######*#*####*#*######*#*####*#*###",
		"####*#*##*#*########*#*##*#*########*#*##*#*########*#*##*#*####",
		"#######**##############**##############**##############**#######",
		"#######**##############**##############**##############**#######",
		"####*#*##*#*########*#*##*#*########*#*##*#*########*#*##*#*####",
		"###*#*####*#*######*#*####*#*######*#*####*#*######*#*####*#*###",
		"##*##########*####*##########*####*##########*####*##########*##",
		"**############****############****############****############**",
		"#*############*##*############*##*############*##*############*#",
		"#*############*##*############*##*############*##*############*#",
		"**############****############****############****############**",
		"##*##########*####*##########*####*##########*####*##########*##",
		"###*#*####*#*######*#*####*#*######*#*####*#*######*#*####*#*###",
		"####*#*##*#*########*#*##*#*########*#*##*#*########*#*##*#*####",
		"#######**##############**##############**##############**#######",
		"#######**##############**##############**##############**#######",
		"####*#*##*#*########*#*##*#*########*#*##*#*########*#*##*#*####",
		"###*#*####*#*######*#*####*#*######*#*####*#*######*#*####*#*###",
		"##*##########*####*##########*####*##########*####*##########*##",
		"**############****############****############****############**",
		"#*############*##*############*##*############*##*############*#",
		"#*############*##*############*##*############*##*############*#",
		"**############****############****############****############**",
		"##*##########*####*##########*####*##########*####*##########*##",
		"###*#*####*#*######*#*####*#*######*#*####*#*######*#*####*#*###",
		"####*#*##*#*########*#*##*#*########*#*##*#*########*#*##*#*####",
		"#######**##############**##############**##############**#######",
		"#######**##############**##############**##############**#######",
		"####*#*##*#*########*#*##*#*########*#*##*#*########*#*##*#*####",
		"###*#*####*#*######*#*####*#*######*#*####*#*######*#*####*#*###",
		"##*##########*####*##########*####*##########*####*##########*##",
		"**############****############****############****############**",
		"#*############*##*############*##*############*##*############*#",
		"#*############*##*############*##*############*##*############*#",
		"**############****############****############****############**",
		"##*##########*####*##########*####*##########*####*##########*##",
		"###*#*####*#*######*#*####*#*######*#*####*#*######*#*####*#*###",
		"####*#*##*#*########*#*##*#*########*#*##*#*########*#*##*#*####",
		"#######**##############**##############**##############**#######",
		"#######**##############**##############**##############**#######",
		"####*#*##*#*########*#*##*#*########*#*##*#*########*#*##*#*####",
		"###*#*####*#*######*#*####*#*######*#*####*#*######*#*####*#*###",
		"##*##########*####*##########*####*##########*####*##########*##",
		"**############****############****############****############**",
		"#*############*##*############*##*############*##*############*#"
	],
	"tiles": {
		"#": 731,
		"*": 542
	}
}
