{
	"title": "menu",
	"grid": [
		"#*############*#",
		"**############**",
		"##*##########*##",
		"###*#*####*#*###",
		"####*#*##*#*####",
		"#######**#######",
		"#######**#######",
		"####*#*##*#*####",
		"###*#*####*#*###",
		"##*##########*##",
		"**############**",
		"#*############*#"
	],
	"tiles": {
		"#": 731,
		"*": 542
	}
}
